*** Transcript generated by Zoom

Start of a transcript of
UNINVITED
(c) 1986 ICOM Simulations, Inc. 626 Wheeling Rd, Wheeling, IL  60090 
An unauthorized adaptation by David Griffith. 
(Type "about" for more information.)
Release 0 / Serial number 121020 / Inform v6.32 Library 6/12pre S
Standard interpreter 1.1 (3Z) / Library serial number 1209??

>l

Darkness
It is pitch dark, and you can't see a thing.
You smell leaking gasoline.

>open door
You see no door here.

>open car door
You see no car door here.

>open car
You see no car here.

>smell
You smell nothing unexpected.
You smell leaking gasoline.

>smell gasoline
You see no gasoline here.

>exit
You can't since the car door is in the way.
You smell leaking gasoline.

>open car door
You see no car door here.

>exit car
You see no car here.

>open door
You see no door here.

>get out of car
You can't see any such thing.

>exit door
You see no door here.

>leave car
You see no car here.

>n
You can't go that way.
You smell leaking gasoline.

>out
You can't since the car door is in the way.
You smell leaking gasoline.

Your dawdling has cost you your life and possibly the life of your brother as well. The cockpit of your car becomes a flaming inferno as gasoline-fed flames engulf it. Your goose is now very well-cooked.


    *** You have died ***


Would you like to RESTART, RESTORE a saved game or QUIT?
> quit
